19 11 test 10 0 2
10 10 10 10 10 10 10 10 10 10 10 10 10 10 10 10 10 10 10
10  0  0  0  0  0  0  0  0  0  0  0  0  0  0  0  0  0 10
10  0 10 10  0  0 10 10  0  0  0 10 10 10 10 10  0  0 10
10  0 10 10  0  0 10 10  0  0  0  0  0  0  0 10 10  0 10
10  0 10 10  0  0 10 10  0  0  0  0  0  0  0 10 10  0 10
10  0 10 10 10 10 10 10  0  0  0  0 10 10 10 10  0  0 10
10  0  0 10 10 10 10 10  0  0  0 10 10  0  0  0  0  0 10
10  0  0  0  0  0 10 10  0  2  0 10 10  0  0  0  0  0 10
10  0  0  0  0  0 10 10  0  0  0 10 10 10 10 10 10  0 10
10  0  0  0  0  0  0  0  0  0  0  0  0  0  0  0  0  0 10
10 10 10 10 10 10 10 10 10 10 10 10 10 10 10 10 10 10 10
